5 5 34
data/concrete.tiles
1 7 1 4   1 4   1 4   1 8
1 1 2 7 0 2 4 0 2 8 0 1 2
1 1 2 1 0 2 0 0 2 2 0 1 2
1 1 2 5 0 2 3 0 2 6 0 1 2
1 5 1 3   1 3   1 3   1 6
