6 5
data/concrete.tiles
1 7 1 4   1 4   1 4   1 4    1 8
1 1 2 0 7 2 0 4 2 0 8 1 0    1 2
1 1 2 0 1 2 0 0 2 0 2 2 0  9 1 2
1 1 2 0 5 2 0 3 2 0 6 2 0 10 1 2
1 5 1 3   1 3   1 3   1 3    1 6
